==========
=B......O=
=..B.B...=
=X......B=
==========