==========
=B.......=
=..B.B...=
=XBO....B=
==========