==========
==.......=
==O==B...=
=.OOB....=
=...=B...=
=.X....===
==========