===============
=.............=
=...X...B.O...=
=.............=
=.............=
===============