===============
=             =
=   x   b o   =
=             =
=             =
===============