===============
=             =
=   X   B O   =
=             =
=             =
===============